   $              $        H
H**X**H    HXXXXXXXXXH $   H
H $ - H    H         HXXXXVH
HX*X*XH    H         H     h
H     H~~~~H~~~~~~  -H     h
H     H    H  $  HXXX******H
H   - H $  HXXXXXH         H
*XXX*XX*XX*H         HXXXHXX
*XXX*      H         H   H  
*$  *      H   ~~~~~~H   H $
XXXXXXXXHXXX****     H  XXXX
        H +          H      
XXXXXXXXXXXXXXXXXXXXXXXXXXXX