~~~~~~~~~~    $            h
H $      HXXXXXXXXXXH      h
XXXXXH - H     $    HX******
     HXXXXXXHXXXXXHXX       
  $  H      H     H  ~~     
XXXXHX      H  -  H    ~~   
    H    HXXXXXXHXX      ~~$
    H~~~~H      H  -       X
    H       HXXXXXXXXXH     
XXXHXXXXXXXXXX   $   XXXXXHX
XXXHXXXXXXXXXX HXXXH XXXXXHX
   H    +      HXXXH   $  H 
XXXXXXXXXXXXXXXXXXXXXXXXXXXX